5 9
1 1 1 1 1 1 1 1 1
1 0 0 0 1 1 0 1 1
1 0 1 0 1 1 0 0 1
1 0 1 0 0 0 0 1 1
1 1 1 1 1 1 1 1 1
2
2 1
2 6
3 1
1 6
3 4

