6 6
1 1 1 1 1 1
1 1 1 0 1 1
1 0 0 0 1 1
1 1 0 0 0 1
1 1 0 1 1 1
1 1 1 1 1 1
3
3 2
3 3
2 3
4 2
3 4
1 3
2 2
