10 6
1 1 1 1 1 1
1 1 0 0 1 1
1 0 0 0 1 1
1 0 0 0 1 1
1 0 0 0 1 1
1 0 0 0 1 1
1 1 0 0 0 1
1 1 0 1 0 1
1 1 0 0 0 1
1 1 1 1 1 1
3
3 2
4 2
5 2
4 2
5 2
6 2
2 2
