7 8
0 0 1 1 1 1 1 0
1 1 1 0 0 0 1 0
1 0 0 0 0 0 1 1
1 0 0 0 0 0 0 1
1 1 1 0 0 0 0 1
0 0 1 0 0 0 1 1
0 0 1 1 1 1 1 0
4
2 3
3 4
4 4
4 5
2 4
3 3
4 4
3 5
2 5
//good

